NO ./textures/bluestone.xpm ./textures/eagle.xpm
SO ./textures/eagle.xpm ./textures/redbrick.xpm ./textures/greystone.xpm ./textures/greystone.xpm
WE ./textures/greystone.xpm ./textures/greystone.xpm ./textures/greystone.xpm
EA ./textures/redbrick.xpm

F 0,0,0
C 255,255,255

UP 50,50,50 ./textures/greystone.xpm
LO ./textures/redbrick.xpm

        1111111111111111111111111
        1000000000110000000000001
111111111111000001110000000000001
100100000000000000000000111111111
111111111011000001110000000000001
100000000011000001110111100111111
11110111111111011100000010001
11110111111111011101010010001
110000001101010111D0000010001
10000000000000000000000000001
100000D0000000001101010010001
110000U1110101011111011100W0111
11110111 1110101 101111010001
11111111 1111111 111111111111
