NO assets/Wall2.xpm assets/Wall0-1.xpm assets/adachi.xpm
SO assets/Wall2.xpm assets/Wall0-2.xpm assets/adachi_rotate.xpm
WE assets/Wall2.xpm assets/Wall0-3.xpm assets/adachi.xpm
EA assets/Wall2.xpm assets/Wall0-4.xpm assets/adachi_rotate.xpm

F 150,150,180 66,77,8
C 163,167,169 242,240,229

DO assets/Door3.xpm assets/Door0Up.xpm
SP assets/light.xpm assets/hand_doom.xpm

        1111111111111111111111111
        1000000000110000000000001
111111111111000001110000000000001
1001000000000000000000001111111111111111111111111111111111111111111111111111111111111111111111111111111111111111111111111111111111
1111111110110000011100000000000000000000000000000000000000000000000000000000000000000000000000000000000000000000000000000000000001
1000000000110000011101111001111111111111111111111111111111111111111111111111111111111111111111111111111111111111111111111111111111
11110111111111011100000010001
11110111111111011101010010001
110000001101010111D0000010001
10000000000000000000000000001
100000D0000000001101010010001
110000D11101010111110111D0WD111
11110111 1110101 101111010001
11111111 1111111 111111111111
